ABENDU: diciembre

ABERATS: rico, adinerado

ABUZTU: agosto

ADIBIDE: ejemplo

ADI EGON: estar atento

ADIMEN: inteligencia

ADITU: 1 escuchar. 2 entender

ADISKIDE: amigo

ADOS: de acuerdo

AFALDU: cenar

AFARI: cena

AGERTU: aparecer

AGUR: 1 adiós. 2 saludo (en general)

AGURE: anciano

AGURTU: 1 saludar. 2 despedir

AHAZTU: olvidar(se)

AHIZPA: hermana (de una mujer)

AHO: boca

AITA: padre

AITONA: abuelo

AITORTU: confesar

ALABA: hija

ALAI: alegre

ALDE: parte, lado

ALDIZKARI: revista

ALFER: vago

ALKANDORA: camisa

ALKATE: alcalde

ALTU: alto

ALTXATU: levantar(se)

ALU: vagina

AMA: madre

AMAITU: terminar

AMONA: abuela

ANAIA: hermano (de un hombre)

ANAI-ARREBAK: hermano(s) y hermana(s)

ANDRE: mujer

ANTZERKI: teatro

APIRIL: abril

APURTU: romper

ARAZO: problema

ARBELA: pizarra, tablero

ARDI: oveja

ARDO: vino

ARGAL: delgado

ARGAZKI: fotografía

ARGI: 1 luz. 2 claro

ARI IZAN: estar haciendo algo

ARIKETA: ejercicio

ARRAIN: pez, pescado

ARRANTZA: 1 pesca. 2 rebuzno

ARRANTZALE: pescador

ARRATS: anochecer

ARRATSALDE: tarde (sust.)

ARRATSALDEON: buenas tardes

ARRAUTZA: huevo

ARRAZOI: razón

ARREBA: hermana (de hombre)

ARTALDE: rebaño de ovejas

ARTAZI: tijeras

ARTE: 1 hasta. 2 entre

ARTO: maiz

ASKATASUN: libertad

ASKATU: 1 liberar. 2 soltar

ASKO: mucho(s)

ASKOTAN: muchas veces

ASMATU: acertar, inventar

ASMO: intención

ASPALDIAN: hace mucho tiempo

ASPALDITIK: desde hace tiempo

ASPERTU: aburrir(se)

ASTE: semana

ASTEARTE: martes

ASTEAZKEN: miércoles

ASTEKARI: semanario

ASTELEHEN: lunes

ASTO: burro

ATARI: portal

ATE: puerta

ATERA: 1 salir. 2 sacar

ATERTU: escampar

ATSEGIN: agradable

ATZE: atrás

ATZO: ayer

AUKERATU: elegir

AULKI: silla

AURKITU: encontrar

AURPEGI: cara, rostro

AURRE: delante, enfrente

AUTO: coche

AUZO: barrio

AZAL: piel

AZALDU: 1 explicar. 2 aparecer

AZARO: noviembre

AZKAR: 1 rápido. 2 listo

AZKEN: último

AZKENEAN: por fin

AZOKA: mercado

AZPI: debajo

AZTERKETA: examen

AZTERTU: examinar

BADAEZPADA: por si acaso

BAI: sí (afirmación)

BAIETZ: 1 que sí. 2 a que sí

BAINA: pero

BAIZIK: sino

BAKARRIK: solo, solamente

BAKOITZ: cada uno

BALDAR: torpe

BALIO IZAN: valer

BALKOI: balcón

BALOI: balón

BARAZKI: verdura

BARKATU: 1 perdonar. 2 ¡perdón!

BARRE: risa

BARRE EGIN: reír

BARRU: parte interior, dentro

BASERRI: caserío

BASERRITAR: habitante de un caserío

BASO: 1 bosque. 2 vaso

BAT: uno

BATZUETAN: algunas veces

BAZKALDU: comer (al mediodía)

BAZKARI: comida (al mediodía)

BEDERATZI: nueve

BEGI: ojo

BEGIRATU: mirar

BEHAR BADA: quizá

BEHAR IZAN: 1 necesitar. 2 deber hace algo

BEHATZ: dedo

BEHE: parte inferior, abajo

BEHI: vaca

BEHINTZAT: al menos

BELAR: hierba

BELARRI: oreja

BELTZ: negro

BENETAN: de verdad

BERANDU: tarde (adv.)

BERAZ: por lo tanto

BERDIN: igual

BEREHALA: enseguida

BEREZI: especial

BERO: 1 calor. 2 caliente

BEROTU: calentar

BERREHUN: doscientos

BERRI: 1 nuevo. 2 noticia

BERRIZ: 1 otra vez. 2 en cambio

BERROGEI: cuarenta

BERROGEITA HAMAR: cincuenta

BERTSO: verso

BESO: brazo

BESTE: otro

BETAURREKO: gafas

BETE: llenar

BETI: siempre

BEZALA: como (modal)

BI: dos

BIDAIA: viaje

BIDE: camino

BIGUN: blando

BIHAR: mañana (adv.)

BIHOTZ: corazón

BIHURRI: travieso

BIKAIN: excelente

BIKOITZ: doble

BILDU: 1 recoger. 2 reunir

BILERA: reunión

BITARTEAN: mientras (tanto)

BIZAR: barba

BIZI IZAN: vivir

BIZITZA: vida

BIZKOR: rápido, fuerte

BOLIGRAFO: bolígrafo

BOST: cinco

BOTA: tirar

BOTIKA: farmacia

BOTILA: botella

BUKATU: acabar

BULEGO: oficina

BURDINA: hierro

BURU: cabeza

DANTZA: baile

DANTZATU: bailar

DARDAR: temblor

DASTATU: probar

DEI: llamada

DEITU: llamar

DENBORA: tiempo

DENDA: tienda

DERRIGORREZKO: obligatorio

DITI: pecho

DITIBURU: pezón

DIRU: dinero

DOHAIN: gratis

DUIN: digno

DORRE: torre

DORTOKA: tortuga

DOTORE: elegante

EDAN: beber

EDARI: bebida

EDER: bonito, bello

EDERKI: bien

EGARRI: sed

EGIA: verdad

EGIN: hacer

EGOKI: adecuado

EGON: estar

EGUN: día

EGUNKARI: periódico

EGUNON: buenos días

EGUR: leña

EGURALDI: tiempo metereológico

EGUTEGI: calendario

EGUZKI: sol

EKAIN: junio

EKARRI: traer

EKIALDE: este, oriente

ELUR: nieve

ELIZ: iglesia

EMAKUME: mujer

EMAN: dar

EMAZTE: esposa

EME: hembra

ERABILI: usar, utilizar

ERAKUTSI: enseñar

ERAMAN: llevar

ERANTZUN: 1 responder. 2 respuesta

ERDI: mitad, medio

ERLOJU: reloj

ERORI: caer(se)

EROSI: comprar

ERRAZ: fácil

ESERI: sentarse

ESKER: gracias

ESKU: mano

ESKUMUTUR: muñeca (de la mano)

ESNATU: despertar(se)

ESNE: leche

ETORBIDE: avenida

ETXE: casa

EZ: no (negación)

EZKER: izquierda

EZTUL: tos

GABE: sin (dirurik gabe, sin dinero)

GABON: 1 buenas noches. 2 navidades (pl.)

GAINERA: además

GALDERA: pregunta

GALDETU: preguntar

GALDU: perder

GARAGARDO: cerveza

GARBI: limpio

GARBITU: limpiar

GAU: noche

GAUR: hoy

GAUZA: cosa

GAZTA: queso

GAZTE: joven

GELA: habitación

GELDIRIK: quieto, parado

GELDITU: pararse

GELTOKI: parada, esatción

GERATU: queder(se)

GERO: luego

GERTATU: suceder

GEZUR: mentira

GILTZA: llave

GIRO: ambiente

GIZAKI: ser humano

GIZARTE: sociedad

GIZON: hombre

GOGO: 1 ganas. 2 espíritu

GOGOR: duro

GOIZ: mañana; goizean, a la mañana

GONA: falda

GOR: sordo

GORDE: guardar

GORRI: rojo

GORROTO: odio

GOSALDU: desayunar

GOSARI: desayuno

GUTXI: poco

HAGIN: muela

HANKA: pierna

HAMAR: diez

HARTU: coger

HASERRE: enfadado

HASERRETU: enfadarse

HAUR: niño / niña

HEGOALDE: sur

HELBIDE: dirección

HELBURU: objetivo

HELDU: 1 llegar. 2 agarrar

HERRI: pueblo

HEZETASUN: humedad

HEZUR: hueso

HIL: 1 morir. 2 matar

HILABETE: mes

HIRI: ciudad

HIRIBURU: capital

HIRU: tres

HITZ: palabra

HITZ EGIN: hablar

HIZKUNTZA: lengua, idioma

HIZTEGI: diccionario

HIZTUN: hablante

HODEI: nube

HOGEI: veinte

HONDARTZA: playa

HORI: amarillo

HORMA: pared

HOTZ: frio

HOZTU: enfriar

HURBIL: cerca

HURBILDU: acercarse

HUSTU: vaciar

HUTSIK: vacio

HUTSUNE: hueco

IBILI: andar

IDATZI: escribir

IDAZLE: escritor

IGANDE: domingo

IGO: subir

IKASGELA: aula

IKASI: 1 aprender. 2 estudiar

IKASLE: alumno

IKASTARO: curso, cursillo

IKASTETXE: colegio

IKUSI: ver

ILE: pelo

INDAR: fuerza

IPARRALDE: norte

IPINI: poner

IPUIN: cuento

IRABAZI: ganar

IRAIL: septiembre

IRAKASLE: profesor

IRAKATSI: enseñar

IRAKURRI: leer

IREKI: abrir

IRENTSI: tragar

IRLA: isla

IRRATI: radio

IRTEERA: salida

IRUDI: imagen, dibujo

IRUDITU: 1 parecer. 2 imarginar

ITURRI: fuente

ITXARON: esperar

ITXASO: mar

ITXI: cerrar

ITZALI: apagar

IXILDU: callarse

IXILIK: en silencio

IZAN: ser

IZAR: estrella

IZEKO: tía

IZOTZ: hielo

JABE: dueño, amo

JAI: fiesta

JAIKI: levantarse

JAINKO: dios

JAIO: nacer

JAITSI: bajar

JAKIN: saber

JAKIN-MIN: curiosidad

JAKA: chaqueta

JAKI: alimento

JAN: comer

JANARI: comida

JANTZI: vestir(se)

JARRAITU: seguir

JARRERA: 1 postura. 2 actitud

JARRI: 1 poner. 2 sentarse

JASAN: soportar, aguantar

JASO: 1 levantar. 2 recibir

JATETXE: restaurante

JAUN: dueño, señor

JENDE: gente

JERTSE: jersei

JEZARRI: sentarse

JO: 1 golpear. 2 tocar

JOAN: ir

JOKATU: 1 jugar. 2 comportarse

JOKU: juego

JOLASTU: jugar

JOSI: coser

JOSTAILU: juguete

JOSTUN: sastre, costurero

KAI: puerto

KAIOLA: jaula

KAIXO: hola (saludo)

KALE: calle

KALTE: 1 daño. 2 perjuicio

KALTEGARRI: perjudicial

KANPO: exterior

KANPORATU: extraer, expulsar

KOMUN: aseo, retrete

KUTXA: caja

LABUR: corto

LAGUN: 1 amigo. 2 persona

LAGUNDU: ayudar

LAGUNTZA: ayuda

LAN: trabajo

LANDARE: planta, vegetal

LAN EGIN: trabajar

LANGILE: trabajador

LAINO: niebla

LARUNBAT: sábado

LARRU: piel

LASTER: pronto

LAU: cuatro

LAZTAN: 1 caricia. 2 amado, querido

LAZTANDU: acariar

LEGE: ley

LEHEN: primero

LEHENBAILEHEN: cuanto antes

LEHIA: competencia

LEKU: sitio, lugar

LIBURU: libro

LIBURUDENDA: librería

LIBURUTEGI: biblioteca

LO EGIN: dormir

LUZE: largo

MAHAI: mesa

MAIATZ: mayo

MAILA: nivel, curso

MAITE: amar, querer

MAKILA: 1 palo. 2 bastón

MAKINA: máquina

MALKO: lágrima

MARGO: pintura

MARGOTU: pintar

MARINEL: marinero

MARMAR: murumullo, murmuración

MARRAZKI: dibujo

MARTXO: marzo

MEHE: delgado

MENDE: siglo

MENDEBALDE: oeste

MENDI: monte

MEREZI: merecer

MERKE: barato

MESEDE: favor

MESEDEZ: por favor

MEZA: misa

MIHI: lengua

MILA: mil

MIN: dolor

MIN EGIN: hacer daño

MIN HARTU: hacerse daño

MINUTU: minuto

MINTZATU: hablar

MIRARI: milagro

MOLDATU: arreglar, apañar

MOTA: clase, tipo

MOTEL: lento, flojo

MOTZ: corto

MOZKOR: 1 borracho. 2 borrachera

MOZKORTI: borracho

MOZKORTU: emborrachar(se)

MOZTU: cortar

MUGA: límite, frontera

MUGITU: move

MUKIZAPI: pañuelo

MUNDU: mundo

MUSIKA: música

MUSU: beso

MUSU EMAN: besar

MUTIL: chico, muchacho

NABARI: patente, manifiesto

NABARITU: percibir, notar

NAGUSI: 1 principal, mayor. 2 jefe, amo

NAHASI: 1 mezclar, -ado. 2 revolver, revuelto. 3 confundir

NAHASTU: vid. NAHASI

NAHI: 1 querer. 2 deseo

NAHIAGO: preferir

NAHIKO: suficiente, bastante

NARRAS: desaliñado, sucio

NAZKA: asco, repugnancia

NAZKAGARRI: asqueroso, repugnante

NAZKATU: asquearse, hartarse

NEBA: hermano (de una mujer)

NEGAR: lloro, llanto

NEGAR EGIN: llorar

NEGU: invierno

NEKATU: cansar(se)

NEKAZARI: labrador, campesino

NESKA: chica

NEURRI: medida

NEURTU: medir

NOIZ: ¿cuándo?

NOIZKO: ¿de cuándo?, ¿para cuándo?

NOIZTIK: ¿desde cuándo?

NOLA: ¿cómo? (de qué modo)

NOLA EDO HALA: de una u otra forma

NOLAKO: ¿cómo? (cualidad: de qué clase, de qué tipo)

NON: ¿dónde?

NONGO: ¿de dónde? (sin movimiento)

NONDIK: ¿de (desde, por) dónde?

NORA: ¿a dónde?

NORAINO: ¿hasta dónde?

NORANTZ: ¿hacia dónde?

NOR: ¿quién?

NORI: ¿a quién? (indirecto)

NORK: ¿quién? (sujeto de v. trans.)

NOREN: ¿de quién?

NOREKIN: ¿con quién?

NORENTZAT: ¿para quién?

NORENGANA: ¿a donde quién?

NORBAIT: ¿alguien?

NOSKI: claro, sin duda

ODOL: sangre

OGI: pan

OGITARTEKO: bocadillo

OHAR: observación, advertencia

OHE: cama

OHERATU: ir a la cama

OHITURA: costumbre

OIHU: grito

OIHUKA: gritando

OILAR: gallo

OILASKO: pollo

OILO: gallina

OIN: pie

OINEZ: a pie

OKER: torcido, mal

OKERTU: torcer

OLATU: ola

OLIO: aceite

ON: bueno

ONARTU: aceptar, admitir

ONDO: bien

ONDOAN: al lado, junto a

ONDOREN: después, a continuación

ONGI: bien

ONTZI: recipiente, vasija

OPARI: regalo

OPOR: vacación

OPORRETAN: de vacaciones

ORAIN: ahora

ORAINDIK: todavía

ORAINTXE: ahora mismo

ORDAINDU: pagar

ORDEA: en cambio

ORDEZ: en vez de

ORDU: hora

ORDUAN: entonces

OROITU: acordarse, recordar

ORRATZ: aguja

ORRAZI: peine

ORRAZTU: peinar

ORRI: hoja

ORRIALDE: página

OSABA: tío

OSASUN: salud

OSATU: 1 completar. 2 sanar, curar(se)

OSO: 1 muy oso polita, "muy bonito, -a". 2 entero

OSPATU: celebrar

OSPETSU: famoso

OSPITALE: hospital

OSTEGUN: jueves

OSTIRAL: viernes

OTSAIL: febrero

OTSO: lobo

PAPER: papel

PARETA: pared

PRAKA: pantalon

PASATU: pasar

PATXADA: sosiego, tranquilidad

PENTSATU: pensar

PERPAUS: frase, oración

PERRETXIKO: seta, hongo

PERTSONA: persona

PETRAL: rebelde, atravesado

PILOTA: pelota

PILOTALEKU: frontón

PILOTARI: pelotari

PISU: peso

PITIN BAT: un poquito

PITXER: jarra

PIXKA BAT: un poco

PIZTU: encender, encendido

PLANTA: actitud, facha

PLATER: plato

PLAZA: plaza

POLIKI: despacio

POLIT: bonito

POLTSIKO: bolsillo

PORRU: puerro

POXPOLU: cerilla, fósforo

POZ: alegría

POZIK: contento

PRESA: prisa

PRESAKA: de prisa

PRESTATU: preparar

PUSKA: pedazo, trozo

PUSKATU: romper

PUTZU: pozo

SABEL: vientre

SAGAR: manzana

SAGARDO: sidra

SAGU: ratón

SAIATU: intentar, esforzarse

SAIO: 1 prueba, ensayo. 2 actuación, función

SAKATU: pulsar, presionar

SAKON: profundo

SALDA: caldo

SALDU: vender

SALGAI: en venta

SALTO: salto

SALTOKA: a saltos

SAMAR: bastante

SAMUR: tierno

SARI: premio

SARRERA: 1 entrada. 2 introducción

SARTU: 1 entrar. 2 meter

SEGURU: seguro

SEGURU ASKI: seguramente

SEI: seis

SEKULA EZ: nunca

SEME: hijo

SEME-ALABAK: hijo(s) e hija(s)

SENAR: marido

SENDAGILE: médico

SENDATU: curar

SENIDE: familar, pariente

SINETSI: creer

SOINEKO: vestido

SOKA: cuerda

SORTU: 1 nacer. 2 crear

SORGIN: bruja

SU: fuego

SUDUR: nariz

SUKALDE: cocina

TALDE: grupo

TANTA: gota

TEILATU: tejado

TELEBISTA: televisión

TELEFONO: teléfono

TOKI: sitio, lugar

TOPO EGIN: encontrarse con alguien

TREBE: hábil

TREN: tren

TRENBIDE: ferrocarril

TRESNA: aparato

TRISTE: triste

TXAKUR: perro

TXALO: aplauso

TXANDA: turno

TXANPON: moneda

TXAPEL: boina

TXAPELDUN: campeón

TXAR: malo

TXERRI: cerdo

TXERTATU: injertar

TXARTO: mal (adv.)

TXIKI: pequeño

TXIMINIA: chimenea

TXISTU: 1 silbido. 2 Instrumento musical

TXOKO: rincón

TXORI: pájaro

TXUKUN: arreglado, aseado

TXUNDITU: asombrar(se)

UDA: verano

UDABERRI: primavera

UDAL: ayuntamiento

UDALETXE casa consistorial

UDAZKEN: otoño

UGARI: abundante

UKATU: negar

UKITU: tocar

ULERTU: comprender, entender

UME: niño / niña

UNIBERTSITATE: universidad

UNE: momento

UR: agua

URDIN: azul

URDURI: nervioso

URRATU: desgarrar

URRI: 1 octubre. 2 escaso

URRUN: lejos

URRUTI: lejos

URTARRIL: enero

URTE: año

URTEBETETZE: cumpleaños

USAIN: olor

USAINDU: oler

USTE: 1 opinar. 2 opinión

UTZI: dejar

UZTAIL: julio

XABOI: jabón

XAHUTU: despilfarrar

XEDE: objetivo, meta

XEHE: menudo

XURGATU: chupar, succionar

ZABAL: ancho

ZABALDU: 1 abrir. 2 extender

ZABALIK: abierto

ZABOR: basura

ZAHAR: viejo

ZAIL: difícil

ZAIN EGON: estar esperando

ZAINDU: cuidar

ZAKAR: rudo, tosco

ZAKIL: pene

ZALDI: caballo

ZALE: aficionado

ZALETASUN: afición

ZAMA: carga

ZAPALDU: aplastar, pisar

ZAPATA: zapato

ZAPI: pañuelo

ZATI: trozo

ZAUNKA: ladrido

ZAURI: herida

ZAZPI: siete

ZEHARO: totalmente, completamente

ZEHATZ: preciso, detallado

ZEIN: cuál, quién

ZELAI: prado

ZENBAKI: número

ZENBAIT: algunos, varios

ZENBAT: ¿cuánto(s)?

ZER: ¿qué?

ZERBAIT: algo

ZERBITZARI: servidor

ZERBITZU: servicio

ZERGA: impuesto

ZERGATIK: ¿por qué?

ZER MODUZ: ¿qué tal?

ZERRENDA: lista

ZERTAN: ¿en qué?

ZERTARA: ¿a qué?

ZERTARAKO: ¿para qué?

ZERTAZ: ¿a cerca de qué?

ZERU: cielo

ZEZEN: toro

ZIGARRO: cigarro

ZIGOR: castigo

ZIGORTU: castigar

ZIKIN: sucio

ZIKINDU: ensuciar

ZINEMA: cine

ZINTZILIK: colgando

ZINTZO: formal, honrado

ZIRRIBORRO: 1 garabato. 2 borrador

ZOPA: sopa

ZORAGARRI: encantador, maravilloso

ZORATU: enloquecer

ZORION: 1 felicidad. 2 enhorabuena (en plural)

ZORIONEZ: afortunadamente

ZORITXAR: desgracia

ZORO: loco

ZORROTZ: 1 afilado, agudo. 2 perspicaz. 3 exigente

ZORROZTU: afilar

ZORTZI: ocho

ZUBI: puente

ZUHAITZ: árbol

ZULO: agujero

ZUR: madera

ZURI: blanco

ZURITU: 1 blanquear. 2 pelar, mondar

ZUTIK: de pie

ZUZEN: derecho

ZUZENDARI: director
